####D#####
#........#
#........#
#........#
D........#
#........D
#........#
#........#
#........#
#####D####