######D#####
#..........#
#..........D
D..........#
#..........#
######D#####