###D####
#......#
#......D
D......#
#......#
###D####