###########D##########
#....................#
#.......S............#
#....................#
#....................#
#.......H............D
D....................#
#....................#
#....................#
#....................#
#....................#
##########D###########