###D###
##....#
#.....#
##...D
#.....#
##....#
#.....#
##....#
#.....#
##....#
#.....#
##....#
#.....#
##....#
#.....#
##....#
#.....#
##....#
#.....#
###D###