###########D##########
#....................#
#....................#
#....................#
#....................#
#....................D
D....................#
#....................#
#....................#
#....................#
#....................#
##########D###########