###########D############
#......................#
#..W...................#
D....W....B.....W......D
#..................W...#
#......................#
############D###########