#############################################
#...........................................#
#...........................................#
#...........................................#
#...........................................#
#...........................................#
#...........................................#
#.....................B.....................#
#...........................................#
#...........................................#
#...........................................#
#...........................................#
#...........................................#
#...........................................#
#...........................................#
#...........................................#
#...........................................#
####################D########################