####################D########################
#...........................................#
#...........................................#
#...........................................#
#...........................................#
#...........................................#
#...........................................#
D.....................B.....................D
#...........................................#
#...........................................#
#...........................................#
#...........................................#
#...........................................#
#...........................................#
#...........................................#
#...........................................#
#...........................................#
####################D########################