###########D##########
#....................#
#....................#
#....................#
#....................#
#....................#
#....................#
#....................#
D.........B..........#
#....................#
#....................#
#....................#
#....................#
#....................#
#....................#
#....................#
############D#########
