#######################
#......E..............#
#.....................D
#..P..................D
#.............E.......#
#....##################
#..E.#,,,,,,,,,,,,,,,,,
#....#,,,,,,,,,,,,,,,,,
#....#,,,,,,,,,,,,,,,,,
#....#,,,,,,,,,,,,,,,,,
#....#,,,,,,,,,,,,,,,,,
#....#,,,,,,,,,,,,,,,,,
#....#,,,,,,,,,,,,,,,,,
##DD##,,,,,,,,,,,,,,,,,

