##DD##,,,,,,,,,,,,,,
#....#,,,,,,,,,,,,,,
#....#,,,,,,,,,,,,,,
#....#,,,,,,,,,,,,,,
#..E.#,,,,,,,,,,,,,,
#....#,,,,,,,,,,,,,,
#....#,,,,,,,,,,,,,,
#.E..###############
#........E.........#
#..................D
#..................D
#.P........E.......#
####################