###########D############
#......................#
#....#..F.....#........#
#....##................#
#......................#
#...........###........D
D......................#
#......................#
#....#.........##......#
#....#......G..##......#
#......................#
############D###########