###########D############
#......................#
#....#..E.....#........#
#....##................#
#......................#
#......P....###........D
D....E.................#
#......................#
#....#......A...##.....#
#....#.........##...P..#
#......................#
############D###########