###########D############
#......................#
#....#..G.....#........#
#....##................#
#......................#
#...........###........D
D......................#
#......................#
#....#.........##......#
#....#.........##......#
#......................#
############D###########