###########D############
#......................#
#.......C..............#
#......................#
#......................#
#......................D
D..........F...........#
#......................#
#......................#
#......................#
#......................#
############D###########