,,,,,,,,,,,,,,##DD##
,,,,,,,,,,,,,,#....#
,,,,,,,,,,,,,,#....#
,,,,,,,,,,,,,,#....#
,,,,,,,,,,,,,,#....#
,,,,,,,,,,,,,,#E...#
,,,,,,,,,,,,,,#...E#
###############....#
#.....E............#
D............P.....#
D..................#
#..........E..E....#
####################