###########D############
#......................#
#.......E..............#
#......................#
#......................#
#......................D
D..........E...........#
#......................#
#......................#
#......................#
#......................#
############D###########