#######################
#.....P....E..........#
#.....................D
#..E..................D
#..........E..........#
#....##################
#..P.#,,,,,,,,,,,,,,,,,
#....#,,,,,,,,,,,,,,,,,
#E...#,,,,,,,,,,,,,,,,,
#....#,,,,,,,,,,,,,,,,,
#....#,,,,,,,,,,,,,,,,,
#....#,,,,,,,,,,,,,,,,,
#....#,,,,,,,,,,,,,,,,,
##DD##,,,,,,,,,,,,,,,,,

