#######################
#.....................#
D.........E.E.........#
D.....................#
#............P........#
##################....#
,,,,,,,,,,,,,,,,,#..E.#
,,,,,,,,,,,,,,,,,#....#
,,,,,,,,,,,,,,,,,#....#
,,,,,,,,,,,,,,,,,#....#
,,,,,,,,,,,,,,,,,#.E..#
,,,,,,,,,,,,,,,,,#....#
,,,,,,,,,,,,,,,,,#....#
,,,,,,,,,,,,,,,,,#....#
,,,,,,,,,,,,,,,,,#....#
,,,,,,,,,,,,,,,,,##DD##