###########D############
#......................#
#....#..A.....#........#
#....##................#
#..........P...........#
#...........###........D
D....E.................#
#......................#
#....#......E...##.....#
#....#..P......##......#
#......................#
############D###########