###########D############
#......................#
#....#..E.....#........#
#....##................#
#.................H....#
#...........###........D
D....E.................#
#......................#
#....#......E...##.....#
#....#.........##......#
#......................#
############D###########