##DD##,,,,,,,,,,,,,,
#....#,,,,,,,,,,,,,,
#....#,,,,,,,,,,,,,,
#....#,,,,,,,,,,,,,,
#....#,,,,,,,,,,,,,,
#....#,,,,,,,,,,,,,,
#..E.#,,,,,,,,,,,,,,
#....###############
#.....P............#
#........E.........D
#..................D
#..E...............#
####################