###########D############
#......................#
#....#..E.....#........#
#....##................#
#.................P....#
#...........###........D
D....E.................#
#......................#
#....#......E...##.....#
#....#.........##......#
#....P.................#
############D###########