###########D############
#......................#
#...A..........A.......#
#......................#
D......####.####.......D
#......................#
#...R..........R.......#
#......................#
############D###########