############D###########
#....T................#
#..###......###.......#
D..#...R....#....A....D
#..###......###.......#
#.................T...#
############D###########