########################
#.......A.......F......#
#......................#
#....######...#####..G.#
#.......#.......#......#
#.......#...W..........#
D...............#......D
#.......#.......#......#
#.....#####.T.#####....#
#................F.L...#
#.....G..........L.....#
########################