############D###########
#......................#
#....#............#....#
#...................R..#
#......................#
#.......A......A.......#
#......................#
#..R..#...........#....#
#......................#
#......................#
############D###########