###D###############D####
#......................#
#..W..W.......T........#
D......................D
#..W..W.......T........#
#......................#
###D###############D####