############D###########
#......................#
#.W..#............#.W..#
#......................#
#......................#
#.......M......M.......#
#......................#
#..W..#...........#.W..#
#......................#
#......................#
############D###########