########################
#...........G..........#
#......................#
#....######.T.#####....#
#.......W........W.....#
#......................#
D......................D
#.......F.......F......#
#.....#####.T.#####....#
#......................#
#...........G..........#
########################