#######################
#............E.......P#
D.....................#
D.....................#
#.......E............E#
##################....#
,,,,,,,,,,,,,,,,,#....#
,,,,,,,,,,,,,,,,,#....#
,,,,,,,,,,,,,,,,,#E...#
,,,,,,,,,,,,,,,,,#....#
,,,,,,,,,,,,,,,,,#...E#
,,,,,,,,,,,,,,,,,#....#
,,,,,,,,,,,,,,,,,#....#
,,,,,,,,,,,,,,,,,#....#
,,,,,,,,,,,,,,,,,#....#
,,,,,,,,,,,,,,,,,##DD##